状況規定	強い	ときは,ときには,際しては,あたっては,当たっては,場合は,場合には,場合においては,場合の外は,限りは,おいては,上は,の際は,のさいは,については,るについては,れば,ならば
状況規定	弱い	とき,ときに,際して,あたって,当たって,場合,場合に,場合において,場合の外,限り,際し,おいて,上,の際,のさい,について,るについて
状況付加	弱い	ときも,ときにも,際しても,あたっても,当たっても,場合も,場合にも,場合においても,場合であっても,場合の外も,おいても,上も,の際も,のさいも,うについても,るについても
別途制定	強い	で定めるところにより,により
状況依存	弱い	事情によって,事情により
手順規定	弱い	によって,により,もって,以て,よって
目的規定	弱い	よう,ように,目的で,うため
適用限定	強い	対しては,ついては,関しては
適用限定	弱い	限度において,限度として
適用付加	弱い	対しても,ついても,関しても
内容規定	弱い	ついて,関し,関して
時間規定	強い	までは,までには,以内には,以内は,前は,前には,後は,後には,までの間は,間には,間は,中は,期間内は,時は,時には
時間規定	弱い	まで,までに,以内に,前,前に,後,後に,までの間,間に,間,中,期間内,時,時に,後において,前において,中において,遅滞なく
時間付加	弱い	までも,までにも,以内にも,以内も,後も,後にも,までの間も,間にも,中も,期間内も,時も,時でも,何時でも,後においても
場所規定	強い	内においては,所においては
場所規定	弱い	内において,所において
適用判断	弱い	旨
接続語	強い	但し,ただし
例外規定	強い	除いては,除く外は,除くほかは,除くの外は,のほかは,の他は,の外は
例外規定	弱い	除き,除いて,除く外,除くほか,除くの外,のほか,の他,の外
原因規定	強い	ので
適用緩和	弱い	でも,かかわらず,よらないで,を問わず
適用制限	弱い	のうち
異種適用	弱い	ものとして
原則規定	弱い	に従って,に従い,に基づき,に基づいて,に基き,に基いて,に応じ,に応じて
反則規定	弱い	に反して,に反し